1	0	108	201	1	153	201	1	153	114	1	108	114	1
2	0	153	201	1	243	201	1	243	114	1	153	114	1
3	0	108	233	1	153	233	1	153	320	1	108	320	1
4	0	153	233	1	243	233	1	243	320	1	153	320	1
5	0	288	201	1	378	201	1	378	114	1	288	114	1
6	0	378	201	1	423	201	1	423	114	1	378	114	1
7	0	288	233	1	378	233	1	378	320	1	288	320	1
8	0	378	233	1	423	233	1	423	320	1	378	320	1
9	0	423	233	1	468	233	1	468	320	1	423	320	1
10	2	108	233	1	243	233	1	243	201	1	108	201	1
11	2	243	233	1	243	320	1	288	320	1	288	233	1
12	2	243	233	1	288	233	1	288	201	1	243	201	1
13	2	243	201	1	243	114	1	288	114	1	288	201	1
14	2	288	233	1	423	233	1	423	201	1	288	201	1
15	2	423	233	1	468	233	1	468	201	1	423	201	1
16	2	423	201	1	423	114	1	468	114	1	468	201	1
17	1	265	276	1								
18	1	445	157	1								
